{
  "do": 0,
  "fa": 1,
  "la": 2,
  "mi": 3,
  "re": 4,
  "si": 5,
  "sol": 6
}